CUSTOMER.firstname  CUSTOMER.lastname  
ahhecfoahi	lgyweujcqa	
avebgciliw	eqdpizmram	
axgzdqsbmm	upfocirpqs	
bkcjkmxmwj	mlvjqmmkcm	
bndhhsrysm	fsgyujipok	
brwsmuzksy	ribdvjwgqi	
bryfkveaua	ogdpedvwfm	
bslgvqetrs	zntevyhziq	
catrvxoeka	enhudxwhia	
cpldookxce	zusucohxby	
cpqavombpd	qrqcazszpf	
ctlwokhuiy	jzwxczsepv	
cwqitgilbt	wsikdvqvow	
cwwlnjdcpn	qrsilscpxv	
cwxovisrbm	eadalggvwa	
datpnkblel	idqawnlrad	
dktpjnnitw	gyedwgifui	
dnlndpbkdd	vggdacefyx	
dnxpuvmczt	bsbbsgqjlz	
dtzxgppmho	rmvmtuwpoi	
dxmzbwgjzj	cwrzbmsukc	
ealzpdhftl	ukaoikmteq	
emrucazfqg	zgjozjwmje	
eqdfzlpcxx	zmpcinfalg	
esujicixds	ttoiivmkgz	
febhikreay	uuxixjvvjg	
fechktoxbw	dqrfmuvsxo	
fexlokvcdq	gnrlrxaxma	
fhajjeksud	gnnkftnhfm	
fjbhcabgap	ognaeckudu	
gjwmiehzsq	dwametfdpv	
gqddfwjsnv	kofzuggwhw	
hfschvflma	qvbvtqwiwj	
hjdcaeehad	pvxfrfcsnt	
hjkzufvvfl	qiuzqqwyfd	
icqhyglklf	ylnxkvocqf	
ifzaejcunj	ytkoksrngl	
ijbvvtqioz	bejyxwwmxd	
insatqijyx	xqpngikqkq	
iqjfsotvbe	lypnkaeahk	
izwwtnfsjr	rgbvttmcza	
jafitgaqfx	vqwpgpvndb	
jwjqkdiamy	subspkwzds	
kbjklunrmd	godnheuxrd	
kdgvaoozkp	kjcvbylrox	
kfavmdxbte	fwzswcowlk	
kjbjwawype	qyzvcprftu	
kmwsxaawrw	bbdscsakty	
krzpndbnmv	upzebqjitx	
lghqoildji	fmjxxuiqdl	
lhgdnkyubk	gccqwqmypb	
lhydtvjrjk	vlrkwniakc	
lnmebhwrna	ofgcydpqwj	
lsuohotlrr	tqrgrnxpyw	
lzgexmgzwd	phcocxopgf	
mwhsfiyout	snbtreqkot	
nfmxrdcimn	uxtpjivwxy	
nhrjxddpvt	csgljfwqum	
ntwqalplnr	ckesnyjbvc	
oaisfmjtpx	yigmbfqqxi	
ocbjvorpoh	lscrlvcdoa	
oiaonjzjgd	wxhplevamv	
olfehhrorc	dvxvrfvmtg	
olqvmfwixa	mrdueqxaye	
oodlblwdqi	klunjwcwnz	
ospoqjrrzo	yqlekupyzb	
phdynkbxlq	crjugvztoa	
pkzvgqpqnj	dlgcjwoakf	
prmuaoeyaq	psvdbvlgkc	
ptmfuwplmq	biqcdxewjf	
pubkmyixbq	jvxfhpnwsx	
pufensqpch	zsshbduljl	
qacdxwpkoz	ojbfebbtqk	
qbteqhuvxw	brbdgjwnhj	
qetkbkzydw	mclqriverg	
qhkaupcwxj	drgmfjuuxv	
qmgmhqlspp	gmiqgjtjie	
qrgjmtzbxw	qgasfecuge	
qrgwpdirgg	fhzsqrhlld	
ralmujwaqd	csmjbfxcef	
rhlsowtupk	amnijgczsx	
rtoaqceysb	atjcshmksk	
rzfzetryxt	pbnoqrapdp	
sgvtoehvtg	fcsbckfjhv	
spkdaronko	bvsfhswkon	
sryebvayhh	lonusjfsiu	
surzmorqpw	itxukxhwhp	
swzjgtdhpa	lpjzrxxdbb	
sxofqunsnd	drelntwctj	
tagkvyjnnq	slmemhaqkx	
tmbyhirict	vptxonjkdh	
tmyjftklcq	hssocwwxko	
tscrteyuho	pbfagkshpl	
ubagkrndmt	phjblqwksp	
ugfrtburkr	tvoopdynoh	
urboapsejg	urfshlnfsd	
uvhyezebxd	tjydgafect	
uwvnyejllj	emriyyyley	
vaeaczoohe	qkflaxjvpt	
vcjllauyte	ulsjxtbisz	
vgckbkbram	rigxmbcmpv	
vjnifjkezz	nvtbobdwjb	
vpcberbmkk	bchqnhynix	
wstpinajsf	juwomaxkmn	
wubzhcyzjb	hizgsfthab	
wuhpewvvmn	adijziqrfj	
xcygrvchej	eaxfahdzoo	
xrkigdntut	yegizebytv	
xrrwzxxuut	yrdmynpwtt	
yjprfisxim	ymezxmxqhd	
ysrznlihbm	pxpzeujaqx	
yxaqsogaoo	jnapbmgemq	
zdprfhbdjz	jvmnipbfso	
zgewbevcja	qejzqmbxzn	
zuagmddrfp	astaykgrmn	
zupalqabqd	mozttcjpuu	
zyqvewujmb	mpakfmmqbr	
